[387,387,387,387,387,387,387,387,387,387,387,387,
              387,02,387,387,387,387,387,02,387,387,387,387,
              387,387,387,387,387,02,387,387,387,387,387,02,
              387,387,387,387,387,387,387,387,387,387,387,387,
              02,02,387,387,387,387,387,387,387,387,387,387,
              387,387,387,02,387,387,387,387,02,02,387,387,
              387,387,387,387,387,02,387,387,387,387,387,387,
              387,387,387,387,387,387,387,387,387,387,387,387,
              01,02,02,02,02,02,02,02,02,02,02,03 ];
